K39	TTCATATGG
K23	TTCAGACTT
K24	TTCGAGCAC
K25	TTGTGTATC
K26	TTGACTATG
K27	TTGCCTAGT
Κ40	TTGTTCGTT
Κ41	TTGTGACTA
Κ42	TTGACGAAT
Κ43	TTGCCAATC
Κ44	TATAACGAG
Κ45	TTCTATAGG
Κ46	TTCATCGAT
Κ47	TTCAGCCAA
Κ48	TTGTTGTAG
Κ49	TTGTGCAAT
Κ50	TTGAGTTGG
Κ51	TTGCCAGAG
Κ64	TATAAGTGG
Κ65	TTCTATCTC
Κ66	TTCAATCGT
Κ67	TTCAGGTAT
Κ68	TTGTATCGA
Κ69	TTGTGGTGT
F40	TTGAGTCAT
F41	TTGGTTGTC
F42	TATAAGCCA
F43	TTCTATGCA
F44	TTCAATGAC
F45	TTCGTTCTA
F46	TTGTAATGG
F47	TTGATAGCA
F48	TTGAGAGTG
F49	TTGGTATGA
F50	TATAGTCTC
F51	TTCTAACAG
F23	TTCAACTAG
F24	TTCGTTGGT
F25	TTGTAAGTC
F26	TTGATCTTG
F27	TTGAGCCTC
F64	TTGGTCTAT
F65	TATAGACAG
F66	TTCTAGTTG
F67	TTCAACATC
F68	TTCGTAGAG
F69	TTGTAGAAC
